1111111111111111111111111111111111111111
1000000000000000000000000000000000000001
1000000000000000000000000000000000000001
1000000000000000000000000000000000000001
1000000000000000000000000000000000000001
1000000000000000000000000000000000000001
1000000000000000000000000000000000000001
1000000000000000000000000000000000000001
1000000000000000000000000000000000000001
1000000000000000000000000000000000000001
1000000000000000000000000000000000000001
1000000000000000000000000000000000000001
1000000000000000000000000000000000000001
1000002220000000022200000000222000000001
1000002220000000022200000000222000000001
1000002220000000022200000000222000000001
1000002220000000022200000000222000000001
1000002220000000022200000000222000000001
1000002220000000022200000000222000000001
1000002220000000022200000000222000000001
1000002220000000022200000000222000000001
1000002220000000022200000000222000000001
1000002220000000022200000000222000000001
1000002220000000022200000000222000000001
1000000000000000011100000000000000000001
1000000000000000000000000000000000000001
1000000000000000000000000000000000000001
1000000000000000000000000000000000000001
1000000000000000000000000000000000000001
1000000000000000000000000000110000000001
1000001100000000000000000000110000000001
1000001100000000000000000000000000000001
1000000000000000000000000000000000000001
1000000000000000000000000000000000000001
1000000000000002222222000000000000000001
1000000000000002222222000000000000000001
1000000000000002200022000000000000000001
1000000000000002200022000000000000000001
1000000000000002200022000000000000000001
1111111111111111111111111111111111111111
