1111111111111111111111111111111111111111
1000000000000000000000000000000000000001
1000000000000000000000000000000000000001
1000000000000000000000000000000000000001
1000000000000000000000000000000000000001
1000000000000000000000000000000000000001
1000000000000000000000000000000000000001
1333333333333333333333333333333333333331
1333333333333333333333333333333333333331
1333333333333333333333333333333333333331
1333333333333333333333333333333333333331
1333333333333333333333333333333333333331
1333333333333333333333333333333333333331
1444444444444444444444444444444444444441
1444444444444444444444444444444444444441
1444444444444444444444444444444444444441
1444444444444444444444444444444444444441
1444444444444444444444444444444444444441
1444444444444444444444444444444444444441
1444444444444444444444444444444444444441
1444444444444444444444444444444444444441
1444444444444444444444444444444444444441
1444444444444444444444444444444444444441
1444444444444444444444444444444444444441
1333333333333333311133333333333333333331
1333333333333333333333333333333333333331
1333333333333333333333333333333333333331
1333333333333333333333333333444444433331
1333333333333333333333333333444444433331
1333333333333333333333333333444444433331
1333331133333333333333333333113333333331
1333331133333333333333333333333333333331
1333333333333333333333333333333333333331
1333333333333333333333333333333333333331
1000000000000002222222000000000000000001
1000000000000002222222000000000000000001
1000000000000002200022000000000000000001
1000000000000002200022000000000000000001
1000000000000002200022000000000000000001
1111111111111111111111111111111111111111
