1111111111111111111111111111111111111111
1000000000000000000000000000000000000001
1000000000000000000000000000000000000001
1000000000000000000000000000000000000001
1333333333333333333333333333333333333331
1333333333333333333333333333333333333331
1333333333333333333333333333333333333331
1333333333333333333333333333333333333331
1333333333333333332333333333333333333331
1000000000000000022000000000000000000001
1000000000000000022000000000000000000001
1000000000000000022000000000000000000001
1000004444444444422000000000000000000001
1000004422222224442200000000000000000001
1000002200000002222222222222000000000001
1000020000000000000442222222000000000001
1000020000000000000444444444222000000001
1000020001111111000444444444442000000001
1000020000000000000444444444442000000001
1000022000000000000440011444442000000001
1000002220000000000440001444442000000001
1000000002222222222000001444442000000001
1000000002222222222200001444142000000001
1000000000000000000000000144142000000001
1000000000000000000000000141142000000001
1000000000000000000000000000002000000001
1000000000000000000002222220022000000001
1000000000000000000000000002220000000001
1333333333333333333333333333333333333331
1333333333333333333333333333333333333331
1333333333333333333333333333333333333331
1333333333333333333333333333333333333331
1333333333333333333333333333333333333331
1333333333333333333333333333333333333331
1000000000000002222222000000000000000001
1000000000000002222222000000000000000001
1000000000000002200022000000000000000001
1000000000000002200022000000000000000001
1000000000000002200022000000000000000001
1111111111111111111111111111111111111111
