1111111111111111111111111111111111111111
1000000000000000000000000000000000000001
1000000000000000000000000000000000000001
1000000000000000000000000000000000000001
1000000000000003333333333333333333333331
1000222222200003333333333333333333333331
1000222222200003300000000000000000000001
1000222222200003300000003300000000000001
1000000000000003300000003300000000000001
1000000000000003300000333333000000000001
1000000044440003300000333333000000000001
1000000044440003300000003300000000000001
1000000000000003300000003300000000000001
1000002223332223322200003300222000000001
1000002223332223322200000000222000000001
1000002223332223322200000000222000000001
1000002223332223322200222200222000000001
1000002223332223322200222200222000000001
1000002223332223322200222200222000000001
1000002224444443322200222200222000000001
1000002224444443322200222200222000000001
1000002224444443322200222200222000000001
1000002224444443322200000000222000000001
1000001114444443311100000000111000000001
1000001113333333311133333333111000000001
1333333333333333333333333333333333333331
1333333333333333333333333333333333333331
1000022222222333333333333333333333333331
1000022222222333333333333333333333333331
1000031133333333333333333333113333333331
1000031133333333333333333333113333333331
1000031133333333333333333333333333333331
1000033333333333333333333333333333333331
1000000000000000000000000000000000000001
1000000000000002222222000000000000000001
1000000000000002222222000000000000000001
1000000000000002200022000000000000000001
1000000000000002200022000000000000000001
1000000000000002200022000000000000000001
1111111111111111111111111111111111111111
