1111111111111111111111111111111111111111
1000000000000000000000000000000000000001
1000000000000000000000000000000000000001
1000000000000000000000000000000000000001
1000000000000000000000000000000000000001
1000000000000000000000000000000000000001
1000000000000000000000000000000000000001
1000000000000000000000000000000000000001
1000000000000000000000000000000000000001
1000000000000000000000333333000000000001
1000000044440000000000333333000000000001
1022200044440000000000000000000000222001
1022200000000000000000000000000000222001
1022202220022220022200000000222000222001
1000002220022220022200000000222000000001
1000002220022220022200000000222000000001
1022202220022220022200222200222002222201
1022202220022220022200222200222002222201
1000002220022220022200222200222000000001
1000002220000000022200222200222000000001
1000002220000000022200222200222000000001
1000002220000000022200222200222003333301
1000002220000000022200000000222003333301
1000001110333333011100000000111000000001
1000001110333333011100000000111000000001
1000000000000000000000000000000000000001
1000000000000000000044444000000000000001
1000022222222000000044444000000002222201
1000022222222000000000000000000002222201
1000000000000000000000000000110000000001
1000001100000000000000000000110000000001
1000001100000000000000000000000000000001
1000000000000000000000000000000000000001
1000000000000000000000000000000000000001
1000000000000002222222000000000000000001
1000000000000002222222000000000000000001
1000000000000002200022000000000000000001
1000000000000002200022000000000000000001
1000000000000002200022000000000000000001
1111111111111111111111111111111111111111
